^^^^^^^^^^^^^^^
^-----p-------^
^-------------^
^-------------^
^-------------^
^-------------^
^^^^^^^^^^^^^^^