tttttttttttttt
t-----!------t
t-----2------t
t-----h------t
t-----w------t
t-----p------t
tttttttttttttt