^^^^^^^^^^^^^^^
^-------------^
^-------------^
^-----p-------^
^-------------^
^-------------^
^^^^^^^^^^^^^^^