l-------------i
ttttttttttttttt
t-------p-----t
t-------------t
t-------------t
t-------^-----t
t-------h-----t
ttttttttttttttr